####################
#..................#
#..................#
#..................#
#..........#########
#..................#
####################